"filename", "language", "C++", "Markdown", "comment", "blank", "total"
"d:\Vscode_win\C++\data_struct\Chapter2_linearlist\LinearList_link.cpp", "C++", 105, 0, 24, 12, 141
"d:\Vscode_win\C++\data_struct\Chapter2_linearlist\Ploynomial.cpp", "C++", 90, 0, 2, 7, 99
"d:\Vscode_win\C++\data_struct\Chapter2_linearlist\StaticLink_List.cpp", "C++", 95, 0, 22, 16, 133
"d:\Vscode_win\C++\data_struct\Chapter2_linearlist\linear_list_sequential.cpp", "C++", 123, 0, 16, 15, 154
"d:\Vscode_win\C++\data_struct\Chapter2_linearlist\其他形式的链表.md", "Markdown", 0, 36, 0, 31, 67
"d:\Vscode_win\C++\data_struct\Chapter3_Stack_And_Queue\bracket_detect.cpp", "C++", 64, 0, 1, 2, 67
"d:\Vscode_win\C++\data_struct\Chapter3_Stack_And_Queue\stack.cpp", "C++", 70, 0, 0, 9, 79
"d:\Vscode_win\C++\data_struct\Chapter3_Stack_And_Queue\test.cpp", "C++", 7, 0, 0, 2, 9
"d:\Vscode_win\C++\data_struct\Chapter3_Stack_And_Queue\trans.cpp", "C++", 23, 0, 3, 2, 28
"d:\Vscode_win\C++\data_struct\Chapter4_String\KMP.cpp", "C++", 107, 0, 3, 11, 121
"d:\Vscode_win\C++\data_struct\Chapter4_String\simple_match.cpp", "C++", 33, 0, 4, 2, 39
"d:\Vscode_win\C++\data_struct\Chapter5_Array_And_Table\array.cpp", "C++", 13, 0, 2, 5, 20
"d:\Vscode_win\C++\data_struct\Chapter5_Array_And_Table\cross_link_list.cpp", "C++", 49, 0, 0, 10, 59
"d:\Vscode_win\C++\data_struct\Chapter5_Array_And_Table\sparse_martix.cpp", "C++", 83, 0, 6, 16, 105
"d:\Vscode_win\C++\data_struct\Chapter5_Array_And_Table\sparse_x.cpp", "C++", 120, 0, 0, 10, 130
"d:\Vscode_win\C++\data_struct\Chapter5_Array_And_Table\zip_martix.cpp", "C++", 59, 0, 13, 14, 86
"d:\Vscode_win\C++\data_struct\readme.md", "Markdown", 0, 4, 0, 2, 6
"Total", "-", 1041, 40, 96, 166, 1343